 ###################################################
@      #         #       #   #           #         #
 ##### # ####### ### ### ### # # ######### # ##### #
 # #   #   #   #     # #   #   # #     #   # #   # #
 # # ##### # ######### ### ### # # ### # ### # ### #
 # # #   # #       #     #   # # # # #   #   #     #
 # # # # # ### # ### # ##### # # # # ##### #########
 #   # # #   # # #   #       # #   #     #     #   #
 # ### # ### # ### ########### ##### ### ##### # # #
 #     # #   #   #   #       # #     #   #   #   # #
 ####### # ### # ### ##### ### # # ### ### # ##### #
 #     #   #   # #   #   #     # # #   #   # #     #
 # ### ##### ### # ### # ##### ### # ##### # # ### #
 # # #     #   #   #   #     #     #       # #   # #
 # # ### ##### ##### ####### ##### ####### ##### # #
 #   # #     #       # #     #     #   #   #     # #
 ### # ### ########### # ####### ### # ##### ##### #
 # #   #   #   #       # #     #   # #   #   #   # #
 # ### # ### # # ##### # # ### ##### ### # ### # # #
 #     #     #       #     #         #     #   #   #
 ###################################################