%###################################################
@........#...........#...........#.......#.........#
%#######.#######.###.#.#######.###.###.#.#.###.#####
%#.....#.........#.#.#.....#.#.#...#...#.#...#.#...#
%#.###.###########.#.#####.#.#.#.###.###.###.#.#.#.#
%#...#...#.....#.....#...#...#...#...#.#...#.#.#.#.#
%###.###.###.#.#.#####.#.#########.###.###.#.#.#.#.#
%#...#.#.....#.#...#...#...#.....#.#...#.#.#.#...#.#
%#.###.#####.#####.#.#####.#.###.#.#.#.#.#.#######.#
%#.#.......#.#.....#...#...#.#.#...#.#...#.#.....#.#
%#.#.#.#####.#.#######.#.###.#.#####.###.#.#.###.#.#
%#.#.#.#...#.#.........#.....#.......#.#.#...#...#.#
%#.###.#.#.#.#####################.###.#.#####.###.#
%#...#...#...#.......#...#.........#.......#.#...#.#
%#.#.###.#####.#######.#.#.#.#####.#######.#.###.#.#
%#.#...#.......#...#...#...#...#.#.#.....#...#...#.#
%#.###.#######.#.#.#.#########.#.#.#.###.###.#.###.#
%#...#.#.....#.#.#...#.....#...#.#.#.#.#.#.#.#.....#
%#####.#.#.###.#.#####.#####.###.#.#.#.#.#.#.#####.#
%#...#.#.#.....#...#.......#...#...#...#.#.#...#.#.#
%#.#.#.###########.#####.#.###.#.#####.#.#.###.#.#.#
%#.#.#.....#.....#.#...#.#...#.#.#...#.#.#.......#.#
%#.#.#.###.#.###.#.#.#.#.#.###.#.#.#.#.#.#.#######.#
%#.#.#...#.#...#.#...#.#.#.#...#.#.#.#.#.#...#.....#
%#.#.#####.###.#.#####.###.#.#.###.#.#.#.#.###.#####
%#.#.........#.#.....#.....#.#.#...#...#.#.#...#...#
%#.#########.#.###.#######.#.#.#.#######.###.###.#.#
%#...#.....#.#...#.......#.#.#.#.#.....#.#...#...#.#
%#.#.#####.#.###.###.###.#.#.###.#.###.#.#.###.#.#.#
%#.#.#.....#.#.....#...#.#.#...#.#.#...#.#.#...#.#.#
%#.#.#.#####.#.#######.#.#.###.#.#.#.###.#.#.###.###
%#.#.#...#...#...#.....#.#...#.#...#...#...#...#...#
%#.#.###.#.#####.#.#.#######.#.#######.#####.#####.#
%#.#...#...#.....#.#.#.....#.#...#.....#...#.#.....#
%#.###.#####.#####.#.#.#.###.###.#.#####.###.#.#####
%#...#...#...#...#.#.#.#...#...#...#...#.....#.#...#
%#####.#.#.#####.#.#.#.###.###.#####.#.#.#####.#.#.#
%#...#.#.#.#.....#.#.#...#...#.....#.#.......#...#.#
%#.#.###.#.###.#.#.#####.###.#####.###############.#
%#.#...#.#.....#.#.....#.#.#.....#.....#...........#
%#.###.#.#######.#####.#.#.###.#######.#.#########.#
%#...#.......#...#.#...#.#...#.#.......#.#.#.....#.#
%###.###.#####.###.#.###.#.#.#.#.#######.#.#.###.#.#
%#...#...#...#.#...#.....#.#.#...#...#...#...#.#...#
%#.#######.#.#.#.#.#########.#######.#.#.###.#.#####
%#.#...#...#...#.#.......#.....#...#...#...#.#...#.#
%#.#.#.#.#######.#.#####.#.###.#.#.#######.#.#.#.#.#
%#...#.#.#.....#.#...#.#...#.#.#.#.#.......#.#.#.#.#
%#.###.#.###.#.#####.#.#####.#.#.#.#.#######.#.#.#.#
%#...#.......#.......#...........#...#.........#...#
%###################################################